0000000000000000000000
0201010101010101010100
0000000000000000000000
0101010101010101010100
0000000000000000000000
0101010101010101010100
0000002000000023000000
0101010101010101010100
0000000010000100000000
0201010101010101210100
0000000000000000000000
0101010101010101010100
0000000002000000000000
0101010101210101010100
0000000000000000000000
0101210101010101010100
0000000000200300000200
0101010101013101010100
0000000000000020000000
0101213101010101010100
0000000003000030000000
0000000000000000000000