0000000000000000000000
0111111111333112211110
0111201111223311122120
0222011110113332111110
0111111330112221111110
0111111111111111112220
0332221110011222111110
0112211111123211111110
0123032111102211111330
0112021111122111130110
0111111122111111311110
0322111111113211111010
0211112211111111332110
0111111111223211111110
0110332112111221111110
0111111123211011112220
0113211112111311111110
0123211121110011231110
0111111221111113211110
0222311111032111111220
0111111321111111012220
0000000000000000000000