0000000000000000000000
0333333333111332233330
0333203333221133322320
0222033330331112333330
0333333110332223333330
0333333333333333332220
0112223330033222333330
0332233333321233333330
0321012333302233333110
0332023333322333310330
0333333322333333133330
0122333333331233333030
0233332233333333112330
0333333333221233333330
0330112332333223333330
0333333321233033332220
0331233332333133333330
0321233323330033213330
0333333223333331233330
0222133333012333333220
0333333123333333032220
0000000000000000000000