0000000000000000000000
0333333333333333333330
0333203333221133323320
0222033330001112333330
0333333310222223333330
0333333332223333333320
0112223332223222333330
0332233332211222333330
0321012333112233333110
0332023333112333330330
0333333322113333333330
0122333333031233330030
0233332333033333330330
0333333333033333330330
0330112332033333330330
0333333321000000330220
0331233332333333333330
0321233323333333213330
0333333333333331233330
0223333333333333333220
0333333333333333032220
0000000000000000000000